                                                                                                    |
                                                      Q          P--P--P--P--P--P--P--P--P          |
                    R    R    R                       RRR        RRRRRRRRRRRRRRRRRRRRRRRRR          |
O----O----O----O----O----O----O----O----O----O----O----O----O----O----O----O----O----O----O----O----|
----------------------------------------------------------------------------------------------------|
                                                                                                    |
P--P--P--P--P--P--P--P--P--P--P--P--P--P--P--P--Q                                                   |
                                                RRR              R    R    R    R    Q RR           |
S----S----S----S----S----S----S----S----S----O----O----O----O----O----O----O----O----O----O----O----|
----------------------------------------------------------------------------------------------------|
     P---P---P-                                                                                     |
   P-- P---P---P--Q           Q                                            P--P--P--P--P--P--P--P-- |
Q  RRRRRRRRRRRRRRRRR          RRR       R    R    R    R         Q RR   Q  RRRRRRRRRRRRRRRRRRRRRR   |
S----S----S----S----O----O----O----O----O----O----O----O----O----O----O----O----O----O----O----O----|
----------------------------------------------------------------------------------------------------|
                                                                                                    |
                      P--P--P--P--Q--                                                               |
R    Q RR             RRRRRRRRRRRRRRRR             R    R    R    R    R    R                       |
O----O----O----O----O----O----O----O----O----O----O----O----O----O----O----O----O----O----O----T----|
----------------------------------------------------------------------------------------------------|
